tip_label	genus	subgenus	section
A_floribunda	Angophora	Angophora	Angophora
A_leiocarpa_1	Angophora	Angophora	Angophora
A_leiocarpa_2	Angophora	Angophora	Angophora
C_aparrerinja	Corymbia	Blakella	Abbreviatae
C_arnhemensis	Corymbia	Corymbia	Corymbia
C_calophylla_1	Corymbia	Corymbia	Calophyllae
C_calophylla_2	Corymbia	Corymbia	Calophyllae
C_calophylla_3	Corymbia	Corymbia	Calophyllae
C_candida	Corymbia	Blakella	Abbreviatae
C_chippendalei	Corymbia	Corymbia	Corymbia
C_chlorolampra	Corymbia	Corymbia	Calophyllae
C_citriodora_1	Corymbia	Blakella	Maculatae
C_citriodora_2	Corymbia	Blakella	Maculatae
C_cliftoniana	Corymbia	Corymbia	Corymbia
C_deserticola_deserticola_1	Corymbia	Corymbia	Corymbia
C_deserticola_deserticola_2	Corymbia	Corymbia	Corymbia
C_eremaea_oligiocarpa	Corymbia	Corymbia	Corymbia
C_eremaea_oligocarpa	Corymbia	Corymbia	Corymbia
C_ficifolia	Corymbia	Corymbia	Calophyllae
C_haematoxylon	Corymbia	Corymbia	Calophyllae
C_henryi_2	Corymbia	Blakella	Maculatae
C_henryi_3	Corymbia	Blakella	Maculatae
C_henryi_4	Corymbia	Blakella	Maculatae
C_leichhardii_1	Corymbia	Blakella	Naviculares
C_leichhardii_2	Corymbia	Blakella	Naviculares
C_lenziana	Corymbia	Corymbia	Corymbia
C_leptoloma	Corymbia	Blakella	Naviculares
C_maculata	Corymbia	Blakella	Maculatae
C_papillosa	Corymbia	Corymbia	Corymbia
C_petalophylla	Corymbia	Blakella	Naviculares
C_polycarpa_1	Corymbia	Corymbia	Corymbia
C_polycarpa_2	Corymbia	Corymbia	Corymbia
C_ptychocarpa_ptychocarpa	Corymbia	Corymbia	Corymbia
C_rhodops	Corymbia	Corymbia	Corymbia
C_scabrida	Corymbia	Blakella	Naviculares
C_setosa_pedicellaris_x_C_brachycarpa	Corymbia-H	Corymbia-H	Corymbia-H
C_setosa_setosa	Corymbia	Corymbia	Corymbia
C_sphaerica	Corymbia	Corymbia	Corymbia
C_terminalis	Corymbia	Corymbia	Corymbia
C_tessellaris_1	Corymbia	Blakella	Abbreviatae
C_tessellaris_2	Corymbia	Blakella	Abbreviatae
C_tessellaris_3	Corymbia	Blakella	Abbreviatae
C_trachyphloia_amphistomatica	Corymbia	Corymbia	Corymbia
C_trachyphloia_trachyphloia_1	Corymbia	Corymbia	Corymbia
C_trachyphloia_trachyphloia_2	Corymbia	Corymbia	Corymbia
C_variegata	Corymbia	Blakella	Maculatae
E_absita	Eucalyptus	Symphyomyrtus	Adnataria
E_acies	Eucalyptus	Eucalyptus	'Frutices' ms
E_adesmophloia	Eucalyptus	Symphyomyrtus	Bisectae
E_aenea	Eucalyptus	Symphyomyrtus	Adnataria
E_aequioperta	Eucalyptus	Symphyomyrtus	Dumaria
E_aequioperta_x_E_sheathiana	Eucalyptus-H	Symphyomyrtus-H	Dumaria-H
E_agglomerata	Eucalyptus	Eucalyptus	Eucalyptus
E_aggregata	Eucalyptus	Symphyomyrtus	Maidenaria
E_alaticaulis	Eucalyptus	Symphyomyrtus	Maidenaria
E_alatissima_1	Eucalyptus	Symphyomyrtus	Bisectae
E_alatissima_2	Eucalyptus	Symphyomyrtus	Bisectae
E_albens_1	Eucalyptus	Symphyomyrtus	Adnataria
E_albens_2	Eucalyptus	Symphyomyrtus	Adnataria
E_albopurpurea_1	Eucalyptus	Symphyomyrtus	Adnataria
E_albopurpurea_2	Eucalyptus	Symphyomyrtus	Adnataria
E_albopurpurea_3	Eucalyptus	Symphyomyrtus	Adnataria
E_albopurpurea_4	Eucalyptus	Symphyomyrtus	Adnataria
E_alipes	Eucalyptus	Symphyomyrtus	'Glandulosae' ms
E_ammophila	Eucalyptus	Symphyomyrtus	Exsertaria
E_amygdalina_1	Eucalyptus	Eucalyptus	Eucalyptus
E_amygdalina_2	Eucalyptus	Eucalyptus	Eucalyptus
E_angulosa_1	Eucalyptus	Symphyomyrtus	Dumaria
E_angulosa_2	Eucalyptus	Symphyomyrtus	Dumaria
E_angulosa_3	Eucalyptus	Symphyomyrtus	Dumaria
E_angustissima	Eucalyptus	Symphyomyrtus	Bisectae
E_annulata	Eucalyptus	Symphyomyrtus	'Glandulosae' ms
E_apodophylla_1	Eucalyptus	Symphyomyrtus	Exsertaria
E_apodophylla_2	Eucalyptus	Symphyomyrtus	Exsertaria
E_apothalassica	Eucalyptus	Eucalyptus	Eucalyptus
E_arachnaea_arachnaea	Eucalyptus	Symphyomyrtus	'Glandulosae' ms
E_arachnaea_arrecta_1	Eucalyptus	Symphyomyrtus	'Glandulosae' ms
E_arachnaea_arrecta_2	Eucalyptus	Symphyomyrtus	'Glandulosae' ms
E_arachnaea_x_E_pluricaulis_intergrade_1	Eucalyptus-H	Symphyomyrtus-H	Glandulosae' ms-H
E_arborella	Eucalyptus	Symphyomyrtus	'Glandulosae' ms
E_arenacea	Eucalyptus	Eucalyptus	Eucalyptus
E_argutifolia	Eucalyptus	Symphyomyrtus	Dumaria
E_aridomontana_1	Eucalyptus	Symphyomyrtus	Adnataria
E_aridomontana_2	Eucalyptus	Symphyomyrtus	Adnataria
E_aridomontana_3	Eucalyptus	Symphyomyrtus	Adnataria
E_armillata	Eucalyptus	Symphyomyrtus	'Glandulosae' ms
E_articulata	Eucalyptus	Symphyomyrtus	'Glandulosae' ms
E_aspersa	Eucalyptus	Symphyomyrtus	Bisectae
E_aspratilis_1	Eucalyptus	Symphyomyrtus	'Glandulosae' ms
E_aspratilis_2	Eucalyptus	Symphyomyrtus	'Glandulosae' ms
E_aspratilis_3	Eucalyptus	Symphyomyrtus	'Glandulosae' ms
E_assimilans_1	Eucalyptus	Symphyomyrtus	Dumaria
E_assimilans_2	Eucalyptus	Symphyomyrtus	Dumaria
E_astringens_redacta_1	Eucalyptus	Symphyomyrtus	'Glandulosae' ms
E_astringens_redacta_2	Eucalyptus	Symphyomyrtus	'Glandulosae' ms
E_astringens_redacta_3	Eucalyptus	Symphyomyrtus	'Glandulosae' ms
E_atrata_1	Eucalyptus	Symphyomyrtus	Adnataria
E_atrata_2	Eucalyptus	Symphyomyrtus	Adnataria
E_baiophylla	Eucalyptus	Symphyomyrtus	'Glandulosae' ms
E_bakeri	Eucalyptus	Symphyomyrtus	Bisectae
E_balladoniensis_balladoniensis	Eucalyptus	Symphyomyrtus	Bisectae
E_bancroftii	Eucalyptus	Symphyomyrtus	Exsertaria
E_baudiniana_1	Eucalyptus	Symphyomyrtus	Dumaria
E_baudiniana_2	Eucalyptus	Symphyomyrtus	Dumaria
E_baudiniana_x_E_oraria_intergrade_1	Eucalyptus-H	Symphyomyrtus-H	Dumaria-H
E_baudiniana_x_E_oraria_intergrade_2	Eucalyptus-H	Symphyomyrtus-H	Dumaria-H
E_baueriana	Eucalyptus	Symphyomyrtus	Adnataria
E_baxteri_1	Eucalyptus	Eucalyptus	Eucalyptus
E_baxteri_2	Eucalyptus	Eucalyptus	Eucalyptus
E_beardiana_1	Eucalyptus	Symphyomyrtus	Bisectae
E_beardiana_2	Eucalyptus	Symphyomyrtus	Bisectae
E_behriana	Eucalyptus	Symphyomyrtus	Adnataria
E_behriana_x_E_xodorata	Eucalyptus-H	Symphyomyrtus-H	Adnataria-H
E_behriana_x_E_largiflorens	Eucalyptus-H	Symphyomyrtus-H	Adnataria-H
E_bicostata	Eucalyptus	Symphyomyrtus	Maidenaria
E_blaxellii_1	Eucalyptus	Symphyomyrtus	'Glandulosae' ms
E_blaxellii_2	Eucalyptus	Symphyomyrtus	'Glandulosae' ms
E_botryoides	Eucalyptus	Symphyomyrtus	Latoangulatae
E_brachycalyx_1	Eucalyptus	Symphyomyrtus	Dumaria
E_brachycalyx_2	Eucalyptus	Symphyomyrtus	Dumaria
E_brandiana	Eucalyptus	Symphyomyrtus	Dumaria
E_brassiana	Eucalyptus	Symphyomyrtus	Exsertaria
E_brevipes_1	Eucalyptus	Symphyomyrtus	Bisectae
E_brevipes_2	Eucalyptus	Symphyomyrtus	Bisectae
E_brevistylis	Eucalyptus	Eucalyptus	Longistylus
E_bridgesiana	Eucalyptus	Symphyomyrtus	Maidenaria
E_brockwayi	Eucalyptus	Symphyomyrtus	Bisectae
E_brownii	Eucalyptus	Symphyomyrtus	Adnataria
E_burracoppinensis	Eucalyptus	Symphyomyrtus	Bisectae
E_cadens	Eucalyptus	Symphyomyrtus	Maidenaria
E_caesia_Boyagin_Rock_1	Eucalyptus	Symphyomyrtus	Bisectae
E_caesia_Boyagin_Rock_2	Eucalyptus	Symphyomyrtus	Bisectae
E_caesia_Southern_rocks	Eucalyptus	Symphyomyrtus	Bisectae
E_caesia_caesia_1	Eucalyptus	Symphyomyrtus	Bisectae
E_caesia_caesia_2	Eucalyptus	Symphyomyrtus	Bisectae
E_caesia_magna_1	Eucalyptus	Symphyomyrtus	Bisectae
E_caesia_magna_2	Eucalyptus	Symphyomyrtus	Bisectae
E_caesia_magna_3	Eucalyptus	Symphyomyrtus	Bisectae
E_caesia_magna_4	Eucalyptus	Symphyomyrtus	Bisectae
E_caesia_magna_5	Eucalyptus	Symphyomyrtus	Bisectae
E_cajuputea	Eucalyptus	Symphyomyrtus	Adnataria
E_calcareana_1	Eucalyptus	Symphyomyrtus	Dumaria
E_calcareana_2	Eucalyptus	Symphyomyrtus	Dumaria
E_calcareana_3	Eucalyptus	Symphyomyrtus	Dumaria
E_calcareana_4	Eucalyptus	Symphyomyrtus	Dumaria
E_calcicola_unita_1	Eucalyptus	Eucalyptus	'Frutices' ms
E_calcicola_unita_2	Eucalyptus	Eucalyptus	'Frutices' ms
E_caleyi_caleyi_x_ovendenii_intergrade	Eucalyptus-H	Symphyomyrtus-H	Adnataria-H
E_caliginosa	Eucalyptus	Eucalyptus	Eucalyptus
E_calycogona_calycogona_1	Eucalyptus	Symphyomyrtus	Bisectae
E_calycogona_calycogona_2	Eucalyptus	Symphyomyrtus	Bisectae
E_calycogona_trachybasis	Eucalyptus	Symphyomyrtus	Bisectae
E_camaldulensis_arida_2	Eucalyptus	Symphyomyrtus	Exsertaria
E_camaldulensis_arida_3	Eucalyptus	Symphyomyrtus	Exsertaria
E_camaldulensis_arida_4	Eucalyptus	Symphyomyrtus	Exsertaria
E_camaldulensis_arida_5	Eucalyptus	Symphyomyrtus	Exsertaria
E_camaldulensis_camaldulensis	Eucalyptus	Symphyomyrtus	Exsertaria
E_camaldulensis_refulgens_1	Eucalyptus	Symphyomyrtus	Exsertaria
E_camaldulensis_refulgens_2	Eucalyptus	Symphyomyrtus	Exsertaria
E_camaldulensis_simulata	Eucalyptus	Symphyomyrtus	Exsertaria
E_cameronii	Eucalyptus	Eucalyptus	Eucalyptus
E_campaspe	Eucalyptus	Symphyomyrtus	'Glandulosae' ms
E_camphora_camphora	Eucalyptus	Symphyomyrtus	Maidenaria
E_canaliculata	Eucalyptus	Symphyomyrtus	Pumilio
E_canescens_beadellii	Eucalyptus	Symphyomyrtus	Dumaria
E_canescens_canescens	Eucalyptus	Symphyomyrtus	Dumaria
E_capillosa_1	Eucalyptus	Symphyomyrtus	'Glandulosae' ms
E_capillosa_2	Eucalyptus	Symphyomyrtus	'Glandulosae' ms
E_capillosa_3	Eucalyptus	Symphyomyrtus	'Glandulosae' ms
E_capillosa_4	Eucalyptus	Symphyomyrtus	'Glandulosae' ms
E_capitanea	Eucalyptus	Symphyomyrtus	Dumaria
E_captiosa	Eucalyptus	Symphyomyrtus	Dumaria
E_carnei	Eucalyptus	Symphyomyrtus	'Glandulosae' ms
E_celastroides_celastroides	Eucalyptus	Symphyomyrtus	Bisectae
E_celastroides_virella_1	Eucalyptus	Symphyomyrtus	Bisectae
E_celastroides_virella_2	Eucalyptus	Symphyomyrtus	Bisectae
E_cerasiformis	Eucalyptus	Symphyomyrtus	'Glandulosae' ms
E_cernua	Eucalyptus	Symphyomyrtus	'Glandulosae' ms
E_chloroclada_2	Eucalyptus	Symphyomyrtus	Exsertaria
E_chloroclada_3	Eucalyptus	Symphyomyrtus	Exsertaria
E_chlorophylla_1	Eucalyptus	Symphyomyrtus	Adnataria
E_chlorophylla_2	Eucalyptus	Symphyomyrtus	Adnataria
E_cladocalyx_crassa	Eucalyptus	Symphyomyrtus	Sejunctae
E_clelandii	Eucalyptus	Symphyomyrtus	Dumaria
E_cneorifolia	Eucalyptus	Symphyomyrtus	Bisectae
E_codonocarpa_1	Eucalyptus	Eucalyptus	Eucalyptus
E_codonocarpa_2	Eucalyptus	Eucalyptus	Eucalyptus
E_comitaexvallis	Eucalyptus	Symphyomyrtus	Dumaria
E_concinna	Eucalyptus	Symphyomyrtus	Dumaria
E_confluens	Eucalyptus	Symphyomyrtus	Platysperma
E_conglobata_conglobata_1	Eucalyptus	Symphyomyrtus	Dumaria
E_conglobata_conglobata_2	Eucalyptus	Symphyomyrtus	Dumaria
E_conglobata_conglobata_3	Eucalyptus	Symphyomyrtus	Dumaria
E_conglobata_conglobata_4	Eucalyptus	Symphyomyrtus	Dumaria
E_conglobata_conglobata_5	Eucalyptus	Symphyomyrtus	Dumaria
E_conica	Eucalyptus	Symphyomyrtus	Adnataria
E_conica_x_E_microcarpa	Eucalyptus-H	Symphyomyrtus-H	Adnataria-H
E_conveniens	Eucalyptus	Eudesmia	Limbatae
E_coolabah	Eucalyptus	Symphyomyrtus	Adnataria
E_cooperiana_1	Eucalyptus	Symphyomyrtus	Bisectae
E_cooperiana_2	Eucalyptus	Symphyomyrtus	Bisectae
E_cooperiana_3	Eucalyptus	Symphyomyrtus	Bisectae
E_cordata_quadrangulosa_1	Eucalyptus	Symphyomyrtus	Maidenaria
E_cordata_quadrangulosa_2	Eucalyptus	Symphyomyrtus	Maidenaria
E_cornuta	Eucalyptus	Symphyomyrtus	'Glandulosae' ms
E_corrugata	Eucalyptus	Symphyomyrtus	Dumaria
E_corynodes	Eucalyptus	Symphyomyrtus	Adnataria
E_cosmophylla_1	Eucalyptus	Symphyomyrtus	Incognitae
E_cosmophylla_2	Eucalyptus	Symphyomyrtus	Incognitae
E_cretata	Eucalyptus	Symphyomyrtus	Dumaria
E_crucis_lanceolata_1	Eucalyptus	Symphyomyrtus	Bisectae
E_crucis_lanceolata_2	Eucalyptus	Symphyomyrtus	Bisectae
E_crucis_lanceolata_3	Eucalyptus	Symphyomyrtus	Bisectae
E_crucis_lanceolata_4	Eucalyptus	Symphyomyrtus	Bisectae
E_crucis_praecipua	Eucalyptus	Symphyomyrtus	Bisectae
E_cullenii	Eucalyptus	Symphyomyrtus	Adnataria
E_cupularis	Eucalyptus	Symphyomyrtus	Exsertaria
E_cyclostoma	Eucalyptus	Symphyomyrtus	Dumaria
E_cylindriflora	Eucalyptus	Symphyomyrtus	'Glandulosae' ms
E_cylindrocarpa_1	Eucalyptus	Symphyomyrtus	Dumaria
E_cylindrocarpa_2	Eucalyptus	Symphyomyrtus	Dumaria
E_dalrympleana_Tasmania_1	Eucalyptus	Symphyomyrtus	Maidenaria
E_dalrympleana_Tasmania_2	Eucalyptus	Symphyomyrtus	Maidenaria
E_dalrympleana_heptantha_1	Eucalyptus	Symphyomyrtus	Maidenaria
E_dalrympleana_heptantha_2	Eucalyptus	Symphyomyrtus	Maidenaria
E_dawsonii	Eucalyptus	Symphyomyrtus	Adnataria
E_deanei	Eucalyptus	Symphyomyrtus	Maidenaria
E_decipiens_1	Eucalyptus	Symphyomyrtus	Bisectae
E_decipiens_2	Eucalyptus	Symphyomyrtus	Bisectae
E_decipiens_3	Eucalyptus	Symphyomyrtus	Bisectae
E_decorticans	Eucalyptus	Symphyomyrtus	Adnataria
E_deflexa	Eucalyptus	Symphyomyrtus	Dumaria
E_delicata	Eucalyptus	Symphyomyrtus	Bisectae
E_dendromorpha	Eucalyptus	Eucalyptus	Eucalyptus
E_densa_densa	Eucalyptus	Symphyomyrtus	'Glandulosae' ms
E_desmondensis	Eucalyptus	Symphyomyrtus	'Glandulosae' ms
E_desmondensis_x_E_occidentalis	Eucalyptus-H	Symphyomyrtus-H	Glandulosae' ms-H
E_deuaensis	Eucalyptus	Eucalyptus	Eucalyptus
E_dielsii_1	Eucalyptus	Symphyomyrtus	'Glandulosae' ms
E_dielsii_2	Eucalyptus	Symphyomyrtus	'Glandulosae' ms
E_diminuta_1	Eucalyptus	Symphyomyrtus	'Glandulosae' ms
E_diminuta_2	Eucalyptus	Symphyomyrtus	'Glandulosae' ms
E_diminuta_3	Eucalyptus	Symphyomyrtus	'Glandulosae' ms
E_diminuta_4	Eucalyptus	Symphyomyrtus	'Glandulosae' ms
E_diminuta_5	Eucalyptus	Symphyomyrtus	'Glandulosae' ms
E_diptera	Eucalyptus	Symphyomyrtus	'Glandulosae' ms
E_discreta	Eucalyptus	Symphyomyrtus	Bisectae
E_dissimulata_1	Eucalyptus	Symphyomyrtus	Bisectae
E_dissimulata_2	Eucalyptus	Symphyomyrtus	Bisectae
E_diversifolia_diversifolia	Eucalyptus	Eucalyptus	'Frutices' ms
E_diversifolia_hesperia	Eucalyptus	Eucalyptus	'Frutices' ms
E_dolichocera	Eucalyptus	Symphyomyrtus	Bisectae
E_dolichorhyncha	Eucalyptus	Symphyomyrtus	Dumaria
E_dorrigoensis	Eucalyptus	Symphyomyrtus	Maidenaria
E_dorrigoensis_x_E_xsaligna	Eucalyptus-H	Symphyomyrtus-H	Maidenaria-H
E_drepanophylla_1	Eucalyptus	Symphyomyrtus	Adnataria
E_drepanophylla_2	Eucalyptus	Symphyomyrtus	Adnataria
E_drepanophylla_3	Eucalyptus	Symphyomyrtus	Adnataria
E_drepanophylla_4	Eucalyptus	Symphyomyrtus	Adnataria
E_drummondii_1	Eucalyptus	Symphyomyrtus	Bisectae
E_drummondii_2	Eucalyptus	Symphyomyrtus	Bisectae
E_dumosa	Eucalyptus	Symphyomyrtus	Dumaria
E_dundasii	Eucalyptus	Symphyomyrtus	'Glandulosae' ms
E_dwyeri	Eucalyptus	Symphyomyrtus	Exsertaria
E_ebbanoensis_ebbanoensis	Eucalyptus	Eudesmia	Limbatae
E_ebbanoensis_photina	Eucalyptus	Eudesmia	Limbatae
E_ecostata_1	Eucalyptus	Symphyomyrtus	Bisectae
E_ecostata_2	Eucalyptus	Symphyomyrtus	Bisectae
E_educta_1	Eucalyptus	Symphyomyrtus	Bisectae
E_educta_2	Eucalyptus	Symphyomyrtus	Bisectae
E_educta_3	Eucalyptus	Symphyomyrtus	Bisectae
E_effusa_effusa	Eucalyptus	Symphyomyrtus	'Glandulosae' ms
E_effusa_exsul_1	Eucalyptus	Symphyomyrtus	'Glandulosae' ms
E_effusa_exsul_2	Eucalyptus	Symphyomyrtus	'Glandulosae' ms
E_elata_1	Eucalyptus	Eucalyptus	Eucalyptus
E_elata_2	Eucalyptus	Eucalyptus	Eucalyptus
E_eremicola_eremicola	Eucalyptus	Symphyomyrtus	Bisectae
E_eremicola_peeneri_1	Eucalyptus	Symphyomyrtus	Bisectae
E_eremicola_peeneri_2	Eucalyptus	Symphyomyrtus	Bisectae
E_erythrocorys_1	Eucalyptus	Eudesmia	Limbatae
E_erythrocorys_2	Eucalyptus	Eudesmia	Limbatae
E_erythrocorys_3	Eucalyptus	Eudesmia	Limbatae
E_erythrocorys_4	Eucalyptus	Eudesmia	Limbatae
E_erythronema_inornata	Eucalyptus	Symphyomyrtus	'Glandulosae' ms
E_eudesmioides_1	Eucalyptus	Eudesmia	Limbatae
E_eudesmioides_2	Eucalyptus	Eudesmia	Limbatae
E_eugenioides	Eucalyptus	Eucalyptus	Eucalyptus
E_ewartiana	Eucalyptus	Symphyomyrtus	Bisectae
E_ewartiana_x_E_leptopoda_arctata	Eucalyptus-H	Symphyomyrtus-H	Bisectae-H
E_exigua	Eucalyptus	Symphyomyrtus	Dumaria
E_exilipes_1	Eucalyptus	Symphyomyrtus	Adnataria
E_exilipes_2	Eucalyptus	Symphyomyrtus	Adnataria
E_exilis_1	Eucalyptus	Eucalyptus	'Frutices' ms
E_exilis_2	Eucalyptus	Eucalyptus	'Frutices' ms
E_expressa	Eucalyptus	Eucalyptus	Eucalyptus
E_exserta	Eucalyptus	Symphyomyrtus	Exsertaria
E_falcata	Eucalyptus	Symphyomyrtus	Bisectae
E_fasciculosa	Eucalyptus	Symphyomyrtus	Adnataria
E_fergusonii_dorsiventralis	Eucalyptus	Symphyomyrtus	Adnataria
E_flavida	Eucalyptus	Symphyomyrtus	'Glandulosae' ms
E_flindersii_1	Eucalyptus	Symphyomyrtus	Exsertaria
E_flindersii_2	Eucalyptus	Symphyomyrtus	Exsertaria
E_flocktoniae_flocktoniae_1	Eucalyptus	Symphyomyrtus	Bisectae
E_flocktoniae_flocktoniae_2	Eucalyptus	Symphyomyrtus	Bisectae
E_flocktoniae_flocktoniae_3	Eucalyptus	Symphyomyrtus	Bisectae
E_flocktoniae_flocktoniae_x_E_occidentalis	Eucalyptus-H	Symphyomyrtus-H	Bisectae-H
E_flocktoniae_hebes	Eucalyptus	Symphyomyrtus	Bisectae
E_foliosa	Eucalyptus	Symphyomyrtus	Bisectae
E_formanii_Broadxleaf_1	Eucalyptus	Symphyomyrtus	Bisectae
E_formanii_Broadxleaf_2	Eucalyptus	Symphyomyrtus	Bisectae
E_formanii_Broadxleaf_3	Eucalyptus	Symphyomyrtus	Bisectae
E_formanii_formanii_1	Eucalyptus	Symphyomyrtus	Bisectae
E_formanii_formanii_2	Eucalyptus	Symphyomyrtus	Bisectae
E_formanii_formanii_3	Eucalyptus	Symphyomyrtus	Bisectae
E_forrestiana	Eucalyptus	Symphyomyrtus	Dumaria
E_fraseri_fraseri_1	Eucalyptus	Symphyomyrtus	Dumaria
E_fraseri_fraseri_2	Eucalyptus	Symphyomyrtus	Dumaria
E_fraseri_melanobasis	Eucalyptus	Symphyomyrtus	Dumaria
E_frenchiana	Eucalyptus	Symphyomyrtus	Dumaria
E_froggattii	Eucalyptus	Symphyomyrtus	Adnataria
E_fruticosa_1	Eucalyptus	Symphyomyrtus	Bisectae
E_fruticosa_2	Eucalyptus	Symphyomyrtus	Bisectae
E_gamophylla	Eucalyptus	Eudesmia	Limbatae
E_gardneri_gardneri	Eucalyptus	Symphyomyrtus	'Glandulosae' ms
E_gardneri_ravensthorpensis	Eucalyptus	Symphyomyrtus	'Glandulosae' ms
E_georgei_fulgida	Eucalyptus	Symphyomyrtus	Dumaria
E_georgei_georgei	Eucalyptus	Symphyomyrtus	Dumaria
E_gillenii_1	Eucalyptus	Symphyomyrtus	Exsertaria
E_gillenii_2	Eucalyptus	Symphyomyrtus	Exsertaria
E_gillii_1	Eucalyptus	Symphyomyrtus	Bisectae
E_gillii_2	Eucalyptus	Symphyomyrtus	Bisectae
E_gittinsii_gittinsii	Eucalyptus	Eudesmia	Limbatae
E_gittinsii_illucida	Eucalyptus	Eudesmia	Limbatae
E_glaucina_1	Eucalyptus	Symphyomyrtus	Exsertaria
E_glaucina_2	Eucalyptus	Symphyomyrtus	Exsertaria
E_glomerosa_1	Eucalyptus	Symphyomyrtus	Bisectae
E_glomerosa_2	Eucalyptus	Symphyomyrtus	Bisectae
E_gomphocephala	Eucalyptus	Symphyomyrtus	Bolites
E_gomphocephala_x_E_zopherophloia_1	Eucalyptus	Symphyomyrtus	Bolites
E_gomphocephala_x_E_zopherophloia_2	Eucalyptus	Symphyomyrtus	Bolites
E_goniantha_goniantha	Eucalyptus	Symphyomyrtus	Bisectae
E_goniocalyx_viridissima	Eucalyptus	Symphyomyrtus	Maidenaria
E_goniocarpa	Eucalyptus	Symphyomyrtus	'Glandulosae' ms
E_gracilis	Eucalyptus	Symphyomyrtus	Bisectae
E_grandis	Eucalyptus	Symphyomyrtus	Latoangulatae
E_granitica	Eucalyptus	Symphyomyrtus	Adnataria
E_grasbyi_1	Eucalyptus	Symphyomyrtus	Bisectae
E_grasbyi_2	Eucalyptus	Symphyomyrtus	Bisectae
E_grasbyi_3	Eucalyptus	Symphyomyrtus	Bisectae
E_grasbyi_4	Eucalyptus	Symphyomyrtus	Bisectae
E_griffithsii	Eucalyptus	Symphyomyrtus	Dumaria
E_grisea	Eucalyptus	Symphyomyrtus	Pumilio
E_grossa_1	Eucalyptus	Symphyomyrtus	'Glandulosae' ms
E_grossa_2	Eucalyptus	Symphyomyrtus	'Glandulosae' ms
E_guilfoylei_1	Eucalyptus	Cruciformes	
E_guilfoylei_2	Eucalyptus	Cruciformes	
E_gypsophila_1	Eucalyptus	Symphyomyrtus	Dumaria
E_gypsophila_2	Eucalyptus	Symphyomyrtus	Dumaria
E_gypsophila_3	Eucalyptus	Symphyomyrtus	Dumaria
E_halophila	Eucalyptus	Symphyomyrtus	Bisectae
E_hebetifolia	Eucalyptus	Symphyomyrtus	'Glandulosae' ms
E_histophylla_1	Eucalyptus	Symphyomyrtus	'Glandulosae' ms
E_histophylla_2	Eucalyptus	Symphyomyrtus	'Glandulosae' ms
E_horistes_Southern_smooth_1	Eucalyptus	Symphyomyrtus	Bisectae
E_horistes_Southern_smooth_2	Eucalyptus	Symphyomyrtus	Bisectae
E_horistes_horistes_1	Eucalyptus	Symphyomyrtus	Bisectae
E_horistes_horistes_2	Eucalyptus	Symphyomyrtus	Bisectae
E_horistes_horistes_3	Eucalyptus	Symphyomyrtus	Bisectae
E_hypolaena	Eucalyptus	Symphyomyrtus	Bisectae
E_incerata	Eucalyptus	Symphyomyrtus	'Glandulosae' ms
E_incrassata_1	Eucalyptus	Symphyomyrtus	Dumaria
E_incrassata_2	Eucalyptus	Symphyomyrtus	Dumaria
E_incrassata_3	Eucalyptus	Symphyomyrtus	Dumaria
E_incrassata_4	Eucalyptus	Symphyomyrtus	Dumaria
E_indurata_1	Eucalyptus	Symphyomyrtus	Bisectae
E_indurata_2	Eucalyptus	Symphyomyrtus	Bisectae
E_infera	Eucalyptus	Symphyomyrtus	Exsertaria
E_insulana	Eucalyptus	Symphyomyrtus	Exsertaria
E_insularis_continentalis	Eucalyptus	Eucalyptus	'Frutices' ms
E_intertexta_1	Eucalyptus	Symphyomyrtus	Adnataria
E_intertexta_2	Eucalyptus	Symphyomyrtus	Adnataria
E_jacksonii_1	Eucalyptus	Eucalyptus	Longistylus
E_jacksonii_2	Eucalyptus	Eucalyptus	Longistylus
E_jensenii	Eucalyptus	Symphyomyrtus	Adnataria
E_jucunda	Eucalyptus	Eudesmia	Limbatae
E_jutsonii_jutsonii	Eucalyptus	Symphyomyrtus	Bisectae
E_kessellii_eugnosta_1	Eucalyptus	Symphyomyrtus	Bisectae
E_kessellii_eugnosta_2	Eucalyptus	Symphyomyrtus	Bisectae
E_kingsmillii_1	Eucalyptus	Symphyomyrtus	Bisectae
E_kingsmillii_2	Eucalyptus	Symphyomyrtus	Bisectae
E_kitsoniana_x_E_ovata_subp_grandiflora	Eucalyptus-H	Symphyomyrtus-H	Maidenaria-H
E_kochii_amaryssia	Eucalyptus	Symphyomyrtus	Bisectae
E_kochii_borealis	Eucalyptus	Symphyomyrtus	Bisectae
E_kochii_kochii	Eucalyptus	Symphyomyrtus	Bisectae
E_kondininensis	Eucalyptus	Symphyomyrtus	Dumaria
E_kruseana_1	Eucalyptus	Symphyomyrtus	'Glandulosae' ms
E_kruseana_2	Eucalyptus	Symphyomyrtus	'Glandulosae' ms
E_kumarlensis_1	Eucalyptus	Symphyomyrtus	Bisectae
E_kumarlensis_2	Eucalyptus	Symphyomyrtus	Bisectae
E_laevis	Eucalyptus	Symphyomyrtus	Dumaria
E_lansdowneana	Eucalyptus	Symphyomyrtus	Adnataria
E_largiflorens_1	Eucalyptus	Symphyomyrtus	Adnataria
E_largiflorens_2	Eucalyptus	Symphyomyrtus	Adnataria
E_largiflorens_3	Eucalyptus	Symphyomyrtus	Adnataria
E_latens_1	Eucalyptus	Symphyomyrtus	Bisectae
E_latens_2	Eucalyptus	Symphyomyrtus	Bisectae
E_latens_3	Eucalyptus	Symphyomyrtus	Bisectae
E_lehmannii_lehmannii	Eucalyptus	Symphyomyrtus	'Glandulosae' ms
E_lehmannii_parallela	Eucalyptus	Symphyomyrtus	'Glandulosae' ms
E_leptocalyx_leptocalyx	Eucalyptus	Symphyomyrtus	Dumaria
E_leptophleba	Eucalyptus	Symphyomyrtus	Adnataria
E_leptophylla_1	Eucalyptus	Symphyomyrtus	Bisectae
E_leptophylla_2	Eucalyptus	Symphyomyrtus	Bisectae
E_leptophylla_3	Eucalyptus	Symphyomyrtus	Bisectae
E_leptopoda_arctata_1	Eucalyptus	Symphyomyrtus	Bisectae
E_leptopoda_arctata_2	Eucalyptus	Symphyomyrtus	Bisectae
E_leptopoda_arctata_3	Eucalyptus	Symphyomyrtus	Bisectae
E_leptopoda_elevata	Eucalyptus	Symphyomyrtus	Bisectae
E_leptopoda_leptopoda	Eucalyptus	Symphyomyrtus	Bisectae
E_leptopoda_subluta	Eucalyptus	Symphyomyrtus	Bisectae
E_leptopoda_x_E_oldfieldii_intergrade	Eucalyptus-H	Symphyomyrtus-H	Bisectae-H
E_lesouefii	Eucalyptus	Symphyomyrtus	Dumaria
E_leucophloia_1	Eucalyptus	Symphyomyrtus	Platysperma
E_leucophloia_2	Eucalyptus	Symphyomyrtus	Platysperma
E_leucophloia_euroa	Eucalyptus	Symphyomyrtus	Platysperma
E_leucophloia_leucophloia	Eucalyptus	Symphyomyrtus	Platysperma
E_leucophylla_1	Eucalyptus	Symphyomyrtus	Adnataria
E_leucophylla_2	Eucalyptus	Symphyomyrtus	Adnataria
E_leucophylla_3	Eucalyptus	Symphyomyrtus	Adnataria
E_leucophylla_4	Eucalyptus	Symphyomyrtus	Adnataria
E_leucophylla_5	Eucalyptus	Symphyomyrtus	Adnataria
E_leucoxylon_megalocarpa_1	Eucalyptus	Symphyomyrtus	Adnataria
E_leucoxylon_megalocarpa_2	Eucalyptus	Symphyomyrtus	Adnataria
E_leucoxylon_megalocarpa_3	Eucalyptus	Symphyomyrtus	Adnataria
E_leucoxylon_pruinosa	Eucalyptus	Symphyomyrtus	Adnataria
E_litorea	Eucalyptus	Symphyomyrtus	Dumaria
E_lockyeri_1	Eucalyptus	Symphyomyrtus	Exsertaria
E_lockyeri_2	Eucalyptus	Symphyomyrtus	Exsertaria
E_lockyeri_3	Eucalyptus	Symphyomyrtus	Exsertaria
E_longirostrata	Eucalyptus	Symphyomyrtus	Pumilio
E_longissima	Eucalyptus	Symphyomyrtus	Bisectae
E_loxophleba_gratiae	Eucalyptus	Symphyomyrtus	'Glandulosae' ms
E_loxophleba_lissophloia	Eucalyptus	Symphyomyrtus	'Glandulosae' ms
E_loxophleba_loxophleba	Eucalyptus	Symphyomyrtus	'Glandulosae' ms
E_loxophleba_supralaevis_1	Eucalyptus	Symphyomyrtus	'Glandulosae' ms
E_loxophleba_supralaevis_2	Eucalyptus	Symphyomyrtus	'Glandulosae' ms
E_lucasii_1	Eucalyptus	Symphyomyrtus	Adnataria
E_lucasii_2	Eucalyptus	Symphyomyrtus	Adnataria
E_mackintii	Eucalyptus	Eucalyptus	Eucalyptus
E_macrandra_1	Eucalyptus	Symphyomyrtus	'Glandulosae' ms
E_macrandra_2	Eucalyptus	Symphyomyrtus	'Glandulosae' ms
E_macrocarpa_elachantha	Eucalyptus	Symphyomyrtus	Bisectae
E_macrocarpa_macrocarpa	Eucalyptus	Symphyomyrtus	Bisectae
E_macrorhyncha_macrorhyncha	Eucalyptus	Eucalyptus	Eucalyptus
E_macta	Eucalyptus	Symphyomyrtus	Latoangulatae
E_malacoxylon	Eucalyptus	Symphyomyrtus	Maidenaria
E_mannensis_mannensis	Eucalyptus	Symphyomyrtus	Bisectae
E_marginata	Eucalyptus	Eucalyptus	Longistylus
E_marginata_Dull_leaf_1	Eucalyptus	Eucalyptus	Longistylus
E_marginata_Dull_leaf_2	Eucalyptus	Eucalyptus	Longistylus
E_megacarpa_1	Eucalyptus	Eucalyptus	'Frutices' ms
E_megacarpa_2	Eucalyptus	Eucalyptus	'Frutices' ms
E_megacornuta	Eucalyptus	Symphyomyrtus	'Glandulosae' ms
E_melanophitra	Eucalyptus	Symphyomyrtus	'Glandulosae' ms
E_melanophloia	Eucalyptus	Symphyomyrtus	Adnataria
E_melanophloia_melanophloia	Eucalyptus	Symphyomyrtus	Adnataria
E_melanophloia_nana	Eucalyptus	Symphyomyrtus	Adnataria
E_melanoxylon	Eucalyptus	Symphyomyrtus	Dumaria
E_merrickiae	Eucalyptus	Symphyomyrtus	Dumaria
E_microcarpa	Eucalyptus	Symphyomyrtus	Adnataria
E_microtheca	Eucalyptus	Symphyomyrtus	Adnataria
E_mimica_continens	Eucalyptus	Symphyomyrtus	'Glandulosae' ms
E_mimica_mimica	Eucalyptus	Symphyomyrtus	'Glandulosae' ms
E_minniritchi	Eucalyptus	Symphyomyrtus	Bisectae
E_misella	Eucalyptus	Symphyomyrtus	Bisectae
E_moderata_1	Eucalyptus	Symphyomyrtus	Bisectae
E_moderata_2	Eucalyptus	Symphyomyrtus	Bisectae
E_molyneuxii	Eucalyptus	Eucalyptus	Eucalyptus
E_moorei_serpentinicola	Eucalyptus	Eucalyptus	Eucalyptus
E_morrisbyi_1	Eucalyptus	Symphyomyrtus	Maidenaria
E_morrisbyi_2	Eucalyptus	Symphyomyrtus	Maidenaria
E_myriadena_1	Eucalyptus	Symphyomyrtus	Dumaria
E_myriadena_2	Eucalyptus	Symphyomyrtus	Dumaria
E_myriadena_3	Eucalyptus	Symphyomyrtus	Dumaria
E_myriadena_4	Eucalyptus	Symphyomyrtus	Dumaria
E_myriadena_5	Eucalyptus	Symphyomyrtus	Dumaria
E_myriadena_6	Eucalyptus	Symphyomyrtus	Dumaria
E_nebulosa_1	Eucalyptus	Eucalyptus	Eucalyptus
E_nebulosa_2	Eucalyptus	Eucalyptus	Eucalyptus
E_neutra_1	Eucalyptus	Symphyomyrtus	Bisectae
E_neutra_2	Eucalyptus	Symphyomyrtus	Bisectae
E_neutra_3	Eucalyptus	Symphyomyrtus	Bisectae
E_neutra_4	Eucalyptus	Symphyomyrtus	Bisectae
E_neutra_5	Eucalyptus	Symphyomyrtus	Bisectae
E_neutra_6	Eucalyptus	Symphyomyrtus	Bisectae
E_normantonensis	Eucalyptus	Symphyomyrtus	Adnataria
E_notactites	Eucalyptus	Symphyomyrtus	Bisectae
E_obesa_1	Eucalyptus	Symphyomyrtus	Bisectae
E_obesa_2	Eucalyptus	Symphyomyrtus	Bisectae
E_obtusiflora_dongarraensis	Eucalyptus	Symphyomyrtus	Dumaria
E_occidentalis	Eucalyptus	Symphyomyrtus	'Glandulosae' ms
E_ochrophloia	Eucalyptus	Symphyomyrtus	Adnataria
E_odorata	Eucalyptus	Symphyomyrtus	Adnataria
E_odorata_x_E_phenax	Eucalyptus-H	Symphyomyrtus-H	Adnataria-H
E_oleosa_ampliata_1	Eucalyptus	Symphyomyrtus	Bisectae
E_oleosa_ampliata_2	Eucalyptus	Symphyomyrtus	Bisectae
E_oleosa_ampliata_3	Eucalyptus	Symphyomyrtus	Bisectae
E_oleosa_cylindroidea	Eucalyptus	Symphyomyrtus	Bisectae
E_oligantha_1	Eucalyptus	Symphyomyrtus	Adnataria
E_oligantha_2	Eucalyptus	Symphyomyrtus	Adnataria
E_oligantha_3	Eucalyptus	Symphyomyrtus	Adnataria
E_oligantha_4	Eucalyptus	Symphyomyrtus	Adnataria
E_oligantha_5	Eucalyptus	Symphyomyrtus	Adnataria
E_olivina_1	Eucalyptus	Symphyomyrtus	Bisectae
E_olivina_2	Eucalyptus	Symphyomyrtus	Bisectae
E_opimiflora	Eucalyptus	Symphyomyrtus	Bisectae
E_optima	Eucalyptus	Symphyomyrtus	Bisectae
E_oraria_1	Eucalyptus	Symphyomyrtus	Dumaria
E_oraria_2	Eucalyptus	Symphyomyrtus	Dumaria
E_orbifolia	Eucalyptus	Symphyomyrtus	Bisectae
E_ornata	Eucalyptus	Symphyomyrtus	Bisectae
E_ovata_grandiflora	Eucalyptus	Symphyomyrtus	Maidenaria
E_ovata_ovata_1	Eucalyptus	Symphyomyrtus	Maidenaria
E_ovata_ovata_2	Eucalyptus	Symphyomyrtus	Maidenaria
E_ovata_ovata_3	Eucalyptus	Symphyomyrtus	Maidenaria
E_ovata_ovata_4	Eucalyptus	Symphyomyrtus	Maidenaria
E_ovularis	Eucalyptus	Symphyomyrtus	Dumaria
E_oxymitra_1	Eucalyptus	Symphyomyrtus	Bisectae
E_oxymitra_2	Eucalyptus	Symphyomyrtus	Bisectae
E_pachycalyx_pachycalyx	Eucalyptus	Symphyomyrtus	Bisectae
E_pallida	Eucalyptus	Eudesmia	Limbatae
E_panda	Eucalyptus	Symphyomyrtus	Adnataria
E_patellaris	Eucalyptus	Symphyomyrtus	Adnataria
E_patens	Eucalyptus	Eucalyptus	Longistylus
E_pauciflora_parvifructa_1	Eucalyptus	Eucalyptus	Eucalyptus
E_pauciflora_parvifructa_2	Eucalyptus	Eucalyptus	Eucalyptus
E_peninsularis_1	Eucalyptus	Symphyomyrtus	Bisectae
E_peninsularis_2	Eucalyptus	Symphyomyrtus	Bisectae
E_peninsularis_3	Eucalyptus	Symphyomyrtus	Bisectae
E_perangusta	Eucalyptus	Symphyomyrtus	Bisectae
E_percostata_1	Eucalyptus	Symphyomyrtus	Dumaria
E_percostata_2	Eucalyptus	Symphyomyrtus	Dumaria
E_perriniana_1	Eucalyptus	Symphyomyrtus	Maidenaria
E_perriniana_2	Eucalyptus	Symphyomyrtus	Maidenaria
E_petiolaris_1	Eucalyptus	Symphyomyrtus	Adnataria
E_petiolaris_2	Eucalyptus	Symphyomyrtus	Adnataria
E_petraea_1	Eucalyptus	Symphyomyrtus	Adnataria
E_petraea_2	Eucalyptus	Symphyomyrtus	Adnataria
E_petraea_3	Eucalyptus	Symphyomyrtus	Adnataria
E_petrensis	Eucalyptus	Symphyomyrtus	Bisectae
E_phaenophylla_2	Eucalyptus	Symphyomyrtus	'Glandulosae' ms
E_phaenophylla_3	Eucalyptus	Symphyomyrtus	'Glandulosae' ms
E_phaenophylla_4	Eucalyptus	Symphyomyrtus	'Glandulosae' ms
E_phenax_compressa	Eucalyptus	Symphyomyrtus	Dumaria
E_phenax_phenax	Eucalyptus	Symphyomyrtus	Dumaria
E_pileata_1	Eucalyptus	Symphyomyrtus	Dumaria
E_pileata_2	Eucalyptus	Symphyomyrtus	Dumaria
E_pileata_3	Eucalyptus	Symphyomyrtus	Dumaria
E_pileata_4	Eucalyptus	Symphyomyrtus	Dumaria
E_pimpiniana	Eucalyptus	Symphyomyrtus	Dumaria
E_planipes_1	Eucalyptus	Symphyomyrtus	Dumaria
E_planipes_2	Eucalyptus	Symphyomyrtus	Dumaria
E_planipes_3	Eucalyptus	Symphyomyrtus	Dumaria
E_planipes_4	Eucalyptus	Symphyomyrtus	Dumaria
E_planipes_5	Eucalyptus	Symphyomyrtus	Dumaria
E_platydisca	Eucalyptus	Eucalyptus	'Frutices' ms
E_platyphylla	Eucalyptus	Symphyomyrtus	Exsertaria
E_platypus_platypus_1	Eucalyptus	Symphyomyrtus	'Glandulosae' ms
E_platypus_platypus_2	Eucalyptus	Symphyomyrtus	'Glandulosae' ms
E_pluricaulis_pluricaulis	Eucalyptus	Symphyomyrtus	'Glandulosae' ms
E_pluricaulis_porphyrea	Eucalyptus	Symphyomyrtus	'Glandulosae' ms
E_polybractea_1	Eucalyptus	Symphyomyrtus	Adnataria
E_polybractea_2	Eucalyptus	Symphyomyrtus	Adnataria
E_populnea_bimbil	Eucalyptus	Symphyomyrtus	Adnataria
E_porosa	Eucalyptus	Symphyomyrtus	Adnataria
E_praetermissa	Eucalyptus	Symphyomyrtus	'Glandulosae' ms
E_preissiana_lobata_1	Eucalyptus	Eucalyptus	'Frutices' ms
E_preissiana_lobata_2	Eucalyptus	Eucalyptus	'Frutices' ms
E_preissiana_lobata_3	Eucalyptus	Eucalyptus	'Frutices' ms
E_prominens	Eucalyptus	Symphyomyrtus	'Glandulosae' ms
E_propinqua	Eucalyptus	Symphyomyrtus	Exsertaria
E_protensa	Eucalyptus	Symphyomyrtus	'Glandulosae' ms
E_pruinosa_pruinosa	Eucalyptus	Symphyomyrtus	Adnataria
E_pterocarpa	Eucalyptus	Symphyomyrtus	Dumaria
E_pulverulenta	Eucalyptus	Symphyomyrtus	Maidenaria
E_punctata_1	Eucalyptus	Symphyomyrtus	Pumilio
E_pyriformis	Eucalyptus	Symphyomyrtus	Bisectae
E_pyrocarpa	Eucalyptus	Eucalyptus	Eucalyptus
E_quadrans	Eucalyptus	Symphyomyrtus	Bisectae
E_quaerenda_1	Eucalyptus	Symphyomyrtus	Bisectae
E_quaerenda_2	Eucalyptus	Symphyomyrtus	Bisectae
E_rameliana	Eucalyptus	Symphyomyrtus	Bisectae
E_raveretiana	Eucalyptus	Symphyomyrtus	Domesticae
E_ravida	Eucalyptus	Symphyomyrtus	'Glandulosae' ms
E_recta_1	Eucalyptus	Symphyomyrtus	Bisectae
E_recta_2	Eucalyptus	Symphyomyrtus	Bisectae
E_reducta	Eucalyptus	Eucalyptus	Eucalyptus
E_redunca	Eucalyptus	Symphyomyrtus	'Glandulosae' ms
E_relicta	Eucalyptus	Symphyomyrtus	Bisectae
E_remota	Eucalyptus	Eucalyptus	Eucalyptus
E_repullulans	Eucalyptus	Symphyomyrtus	Dumaria
E_revelata_ms	Eucalyptus	?	?
E_rigens	Eucalyptus	Symphyomyrtus	Dumaria
E_rigidula_1	Eucalyptus	Symphyomyrtus	Bisectae
E_rigidula_10	Eucalyptus	Symphyomyrtus	Bisectae
E_rigidula_11	Eucalyptus	Symphyomyrtus	Bisectae
E_rigidula_12	Eucalyptus	Symphyomyrtus	Bisectae
E_rigidula_13	Eucalyptus	Symphyomyrtus	Bisectae
E_rigidula_2	Eucalyptus	Symphyomyrtus	Bisectae
E_rigidula_4	Eucalyptus	Symphyomyrtus	Bisectae
E_rigidula_5	Eucalyptus	Symphyomyrtus	Bisectae
E_rigidula_6	Eucalyptus	Symphyomyrtus	Bisectae
E_rigidula_7	Eucalyptus	Symphyomyrtus	Bisectae
E_rigidula_8	Eucalyptus	Symphyomyrtus	Bisectae
E_rigidula_9	Eucalyptus	Symphyomyrtus	Bisectae
E_robusta_x_E_tereticornis	Eucalyptus-H	Symphyomyrtus-H	Latoangulatae-H
E_rosacea_1	Eucalyptus	Symphyomyrtus	Bisectae
E_rosacea_2	Eucalyptus	Symphyomyrtus	Bisectae
E_rubida_canobolensis	Eucalyptus	Symphyomyrtus	Maidenaria
E_rubiginosa	Eucalyptus	Eucalyptus	'Primitiva' ms
E_rudis_cratyantha_1	Eucalyptus	Symphyomyrtus	Exsertaria
E_rudis_cratyantha_2	Eucalyptus	Symphyomyrtus	Exsertaria
E_rudis_cratyantha_3	Eucalyptus	Symphyomyrtus	Exsertaria
E_rugosa	Eucalyptus	Symphyomyrtus	Dumaria
E_rummeryi	Eucalyptus	Symphyomyrtus	Adnataria
E_rupestris_1	Eucalyptus	Symphyomyrtus	Platysperma
E_rupestris_2	Eucalyptus	Symphyomyrtus	Platysperma
E_sabulosa_x_E_ovata_ovata	Eucalyptus-H	Symphyomyrtus-H	Maidenaria-H
E_salmonophloia	Eucalyptus	Symphyomyrtus	Bisectae
E_salubris	Eucalyptus	Symphyomyrtus	'Glandulosae' ms
E_sargentii_sargentii_1	Eucalyptus	Symphyomyrtus	'Glandulosae' ms
E_sargentii_sargentii_2	Eucalyptus	Symphyomyrtus	'Glandulosae' ms
E_sargentii_sargentii_3	Eucalyptus	Symphyomyrtus	'Glandulosae' ms
E_scoparia	Eucalyptus	Symphyomyrtus	Maidenaria
E_scyphocalyx_1	Eucalyptus	Symphyomyrtus	Dumaria
E_scyphocalyx_2	Eucalyptus	Symphyomyrtus	Dumaria
E_sepulcralis	Eucalyptus	Eucalyptus	'Frutices' ms
E_sessilis	Eucalyptus	Symphyomyrtus	Bisectae
E_sheathiana_1	Eucalyptus	Symphyomyrtus	Dumaria
E_sheathiana_2	Eucalyptus	Symphyomyrtus	Dumaria
E_sheathiana_3	Eucalyptus	Symphyomyrtus	Dumaria
E_sheathiana_4	Eucalyptus	Symphyomyrtus	Dumaria
E_shirleyi	Eucalyptus	Symphyomyrtus	Adnataria
E_sicilifolia	Eucalyptus	Symphyomyrtus	Adnataria
E_sideroxylon	Eucalyptus	Symphyomyrtus	Adnataria
E_sieberi	Eucalyptus	Eucalyptus	Eucalyptus
E_socialis_socialis_1	Eucalyptus	Symphyomyrtus	Bisectae
E_socialis_socialis_2	Eucalyptus	Symphyomyrtus	Bisectae
E_socialis_socialis_3	Eucalyptus	Symphyomyrtus	Bisectae
E_socialis_victoriensis_1	Eucalyptus	Symphyomyrtus	Bisectae
E_socialis_victoriensis_2	Eucalyptus	Symphyomyrtus	Bisectae
E_socialis_viridans	Eucalyptus	Symphyomyrtus	Bisectae
E_sp	Eucalyptus	?	?
E_sp_Adelaide	Eucalyptus	Symphyomyrtus	Adnataria
E_sp_Cable_Haul_Road_1	Eucalyptus	Symphyomyrtus	Bisectae
E_sp_Cable_Haul_Road_2	Eucalyptus	Symphyomyrtus	Bisectae
E_sp_Dartmoor_1	Eucalyptus	Symphyomyrtus	Dumaria
E_sp_Dartmoor_2	Eucalyptus	Symphyomyrtus	Dumaria
E_sp_Dunbar_Road_1	Eucalyptus	Symphyomyrtus	Bisectae
E_sp_Dunbar_Road_2	Eucalyptus	Symphyomyrtus	Bisectae
E_sp_Great_Victoria_Desert_1	Eucalyptus	Symphyomyrtus	Bisectae
E_sp_Great_Victoria_Desert_2	Eucalyptus	Symphyomyrtus	Bisectae
E_sp_Great_Victoria_Desert_3	Eucalyptus	Symphyomyrtus	Bisectae
E_sp_Great_Victoria_Desert_4	Eucalyptus	Symphyomyrtus	Bisectae
E_sp_Kalbarri_1	Eucalyptus	Symphyomyrtus	Bisectae
E_sp_Kalbarri_2	Eucalyptus	Symphyomyrtus	Bisectae
E_sp_Kitchener_1	Eucalyptus	?	?
E_sp_Kitchener_2	Eucalyptus	?	?
E_sp_Lake_Magenta_1	Eucalyptus	Symphyomyrtus	Dumaria
E_sp_Lake_Magenta_2	Eucalyptus	Symphyomyrtus	Dumaria
E_sp_Mulga_Rock_1	Eucalyptus	Symphyomyrtus	Bisectae
E_sp_Mulga_Rock_2	Eucalyptus	Symphyomyrtus	Bisectae
E_sp_Mulga_Rock_3	Eucalyptus	?	?
E_sp_Mulga_Rock_4	Eucalyptus	?	?
E_sp_Queen_Victoria_Spring_1	Eucalyptus	Symphyomyrtus	Dumaria
E_sp_Queen_Victoria_Spring_2	Eucalyptus	Symphyomyrtus	Dumaria
E_sp_South_Newdegate_Lakes	Eucalyptus	?	?
E_sp_Southern_wheatbelt_1	Eucalyptus	Symphyomyrtus	Dumaria
E_sp_Southern_wheatbelt_2	Eucalyptus	Symphyomyrtus	Dumaria
E_sp_Sullivan_Soak_1	Eucalyptus	Symphyomyrtus	Bisectae
E_sp_Sullivan_Soak_2	Eucalyptus	Symphyomyrtus	Bisectae
E_sp_Sullivan_Soak_3	Eucalyptus	Symphyomyrtus	Bisectae
E_sp_Sullivan_Soak_4	Eucalyptus	Symphyomyrtus	Bisectae
E_spathulata_spathulata	Eucalyptus	Symphyomyrtus	'Glandulosae' ms
E_spectatrix	Eucalyptus	Eucalyptus	Eucalyptus
E_sporadica_1	Eucalyptus	Symphyomyrtus	'Glandulosae' ms
E_sporadica_2	Eucalyptus	Symphyomyrtus	'Glandulosae' ms
E_sporadica_3	Eucalyptus	Symphyomyrtus	'Glandulosae' ms
E_sporadica_4	Eucalyptus	Symphyomyrtus	'Glandulosae' ms
E_sporadica_5	Eucalyptus	Symphyomyrtus	'Glandulosae' ms
E_spreta	Eucalyptus	Symphyomyrtus	Dumaria
E_staeri	Eucalyptus	Eucalyptus	Longistylus
E_steedmanii	Eucalyptus	Symphyomyrtus	'Glandulosae' ms
E_stellulata_Little_Star	Eucalyptus	Eucalyptus	Eucalyptus
E_stoatei	Eucalyptus	Symphyomyrtus	Dumaria
E_stowardii_1	Eucalyptus	Symphyomyrtus	'Glandulosae' ms
E_stowardii_2	Eucalyptus	Symphyomyrtus	'Glandulosae' ms
E_striaticalyx_1	Eucalyptus	Symphyomyrtus	Dumaria
E_striaticalyx_2	Eucalyptus	Symphyomyrtus	Dumaria
E_stricklandii	Eucalyptus	Symphyomyrtus	'Glandulosae' ms
E_stricta	Eucalyptus	Eucalyptus	Eucalyptus
E_subangusta_cerina	Eucalyptus	Symphyomyrtus	'Glandulosae' ms
E_subangusta_pusilla	Eucalyptus	Symphyomyrtus	'Glandulosae' ms
E_subangusta_subangusta	Eucalyptus	Symphyomyrtus	'Glandulosae' ms
E_subtilis_1	Eucalyptus	Symphyomyrtus	'Glandulosae' ms
E_subtilis_2	Eucalyptus	Symphyomyrtus	'Glandulosae' ms
E_subtilis_3	Eucalyptus	Symphyomyrtus	'Glandulosae' ms
E_suffulgens	Eucalyptus	Symphyomyrtus	Adnataria
E_suggrandis_promiscua	Eucalyptus	Symphyomyrtus	'Glandulosae' ms
E_suggrandis_suggrandis_1	Eucalyptus	Symphyomyrtus	'Glandulosae' ms
E_suggrandis_suggrandis_2	Eucalyptus	Symphyomyrtus	'Glandulosae' ms
E_sweedmaniana	Eucalyptus	Symphyomyrtus	Dumaria
E_synandra_1	Eucalyptus	Symphyomyrtus	Bisectae
E_synandra_2	Eucalyptus	Symphyomyrtus	Bisectae
E_synandra_3	Eucalyptus	Symphyomyrtus	Bisectae
E_synandra_4	Eucalyptus	Symphyomyrtus	Bisectae
E_talyuberlup	Eucalyptus	Symphyomyrtus	'Glandulosae' ms
E_tenera_1	Eucalyptus	Symphyomyrtus	'Glandulosae' ms
E_tenera_2	Eucalyptus	Symphyomyrtus	'Glandulosae' ms
E_tenuis	Eucalyptus	Symphyomyrtus	Dumaria
E_tephroclada	Eucalyptus	Symphyomyrtus	'Glandulosae' ms
E_terebra	Eucalyptus	Symphyomyrtus	'Glandulosae' ms
E_tereticornis_rotunda_1	Eucalyptus	Symphyomyrtus	Exsertaria
E_tereticornis_rotunda_2	Eucalyptus	Symphyomyrtus	Exsertaria
E_tereticornis_tereticornis_1	Eucalyptus	Symphyomyrtus	Exsertaria
E_tereticornis_tereticornis_2	Eucalyptus	Symphyomyrtus	Exsertaria
E_tereticornis_tereticornis_3	Eucalyptus	Symphyomyrtus	Exsertaria
E_tholiformis_1	Eucalyptus	Symphyomyrtus	Adnataria
E_tholiformis_2	Eucalyptus	Symphyomyrtus	Adnataria
E_thozetiana	Eucalyptus	Symphyomyrtus	Adnataria
E_torquata	Eucalyptus	Symphyomyrtus	Dumaria
E_tortilis	Eucalyptus	Symphyomyrtus	'Glandulosae' ms
E_transcontinentalis	Eucalyptus	Symphyomyrtus	Bisectae
E_tricarpa	Eucalyptus	Symphyomyrtus	Adnataria
E_trivalva_1	Eucalyptus	Symphyomyrtus	'Glandulosae' ms
E_trivalva_2	Eucalyptus	Symphyomyrtus	'Glandulosae' ms
E_tumida	Eucalyptus	Symphyomyrtus	'Glandulosae' ms
E_uncinata_Esperance_Plains_1	Eucalyptus	Symphyomyrtus	Bisectae
E_uncinata_Esperance_Plains_2	Eucalyptus	Symphyomyrtus	Bisectae
E_uncinata_uncinata_1	Eucalyptus	Symphyomyrtus	Bisectae
E_uncinata_uncinata_2	Eucalyptus	Symphyomyrtus	Bisectae
E_urna_1	Eucalyptus	Symphyomyrtus	Bisectae
E_urna_2	Eucalyptus	Symphyomyrtus	Bisectae
E_utilis_1	Eucalyptus	Symphyomyrtus	'Glandulosae' ms
E_utilis_2	Eucalyptus	Symphyomyrtus	'Glandulosae' ms
E_utilis_3	Eucalyptus	Symphyomyrtus	'Glandulosae' ms
E_varia_2	Eucalyptus	Symphyomyrtus	'Glandulosae' ms
E_varia_3	Eucalyptus	Symphyomyrtus	'Glandulosae' ms
E_vegrandis_recondita_1	Eucalyptus	Symphyomyrtus	'Glandulosae' ms
E_vegrandis_recondita_2	Eucalyptus	Symphyomyrtus	'Glandulosae' ms
E_vegrandis_vegrandis_1	Eucalyptus	Symphyomyrtus	'Glandulosae' ms
E_vegrandis_vegrandis_2	Eucalyptus	Symphyomyrtus	'Glandulosae' ms
E_verrucata	Eucalyptus	Eucalyptus	Eucalyptus
E_victrix_1	Eucalyptus	Symphyomyrtus	Adnataria
E_victrix_2	Eucalyptus	Symphyomyrtus	Adnataria
E_victrix_3	Eucalyptus	Symphyomyrtus	Adnataria
E_viminalis_cygnetensis	Eucalyptus	Symphyomyrtus	Maidenaria
E_viminalis_hentyensis_1	Eucalyptus	Symphyomyrtus	Maidenaria
E_viminalis_hentyensis_2	Eucalyptus	Symphyomyrtus	Maidenaria
E_virginea	Eucalyptus	Symphyomyrtus	Bisectae
E_vokesensis	Eucalyptus	Symphyomyrtus	Bisectae
E_wandoo_pulverea_1	Eucalyptus	Symphyomyrtus	'Glandulosae' ms
E_wandoo_pulverea_2	Eucalyptus	Symphyomyrtus	'Glandulosae' ms
E_wandoo_wandoo	Eucalyptus	Symphyomyrtus	'Glandulosae' ms
E_websteriana_1	Eucalyptus	Symphyomyrtus	Bisectae
E_websteriana_2	Eucalyptus	Symphyomyrtus	Bisectae
E_websteriana_3	Eucalyptus	Symphyomyrtus	Bisectae
E_websteriana_4	Eucalyptus	Symphyomyrtus	Bisectae
E_websteriana_5	Eucalyptus	Symphyomyrtus	Bisectae
E_wimmerensis	Eucalyptus	Symphyomyrtus	Adnataria
E_woodwardii_1	Eucalyptus	Symphyomyrtus	Dumaria
E_woodwardii_2	Eucalyptus	Symphyomyrtus	Dumaria
E_wyolensis	Eucalyptus	Symphyomyrtus	Bisectae
E_x_alpina_1	Eucalyptus-H	Eucalyptus-H	Eucalyptus-H
E_x_alpina_2	Eucalyptus-H	Eucalyptus-H	Eucalyptus-H
E_x_balanopelex	Eucalyptus-H	Symphyomyrtus-H	Bisectae-H
E_x_brachyphylla_1	Eucalyptus-H	Symphyomyrtus-H	Glandulosae' ms-H
E_x_brachyphylla_2	Eucalyptus-H	Symphyomyrtus-H	Glandulosae' ms-H
E_x_bunyip_1	Eucalyptus-H	Symphyomyrtus-H	Maidenaria-H
E_x_bunyip_2	Eucalyptus-H	Symphyomyrtus-H	Maidenaria-H
E_x_carolaniae_1	Eucalyptus-H	Symphyomyrtus-H	Maidenaria-H
E_x_carolaniae_2	Eucalyptus-H	Symphyomyrtus-H	Maidenaria-H
E_x_hawkeri_1	Eucalyptus-H	Symphyomyrtus-H	Adnataria-H
E_x_hawkeri_2	Eucalyptus-H	Symphyomyrtus-H	Adnataria-H
E_x_impensa	Eucalyptus-H	Symphyomyrtus-H	Bisectae-H
E_x_pruiniramis	Eucalyptus-H	Symphyomyrtus-H	Glandulosae' ms-H
E_x_redimulicifera	Eucalyptus-H	Symphyomyrtus-H	Dumaria-H
E_x_walshii_1	Eucalyptus-H	?	?
E_x_walshii_2	Eucalyptus-H	?	?
E_xanthonema_apposita	Eucalyptus	Symphyomyrtus	'Glandulosae' ms
E_xanthonema_xanthonema	Eucalyptus	Symphyomyrtus	'Glandulosae' ms
E_xerothermica_1	Eucalyptus	Symphyomyrtus	Adnataria
E_xerothermica_2	Eucalyptus	Symphyomyrtus	Adnataria
E_xerothermica_3	Eucalyptus	Symphyomyrtus	Adnataria
E_yalatensis	Eucalyptus	Symphyomyrtus	Bisectae
E_yilgarnensis_1	Eucalyptus	Symphyomyrtus	Bisectae
E_yilgarnensis_2	Eucalyptus	Symphyomyrtus	Bisectae
E_yilgarnensis_3	Eucalyptus	Symphyomyrtus	Bisectae
E_youngiana_1	Eucalyptus	Symphyomyrtus	Bisectae
E_youngiana_2	Eucalyptus	Symphyomyrtus	Bisectae
E_yumbarrana	Eucalyptus	Symphyomyrtus	Bisectae
E_zopherophloia	Eucalyptus	Symphyomyrtus	'Glandulosae' ms
A_floribunda_Ferguson2024	Angophora	Angophora	Angophora
C_calophylla_Ferguson2024	Corymbia	Corymbia	Calophyllae
C_maculata_Ferguson2024	Corymbia	Blakella	Maculatae
E_albens_Ferguson2024	Eucalyptus	Symphyomyrtus	Adnataria
E_ANBG9806169_Ferguson2024	Eucalyptus	Eucalyptus	Eucalyptus
E_brandiana_Ferguson2024	Eucalyptus	Symphyomyrtus	Dumaria
E_caleyi_Ferguson2024	Eucalyptus	Symphyomyrtus	Adnataria
E_camaldulensis_Ferguson2024	Eucalyptus	Symphyomyrtus	Exsertaria
E_cladocalyx_Ferguson2024	Eucalyptus	Symphyomyrtus	Sejunctae
E_cloeziana_Ferguson2024	Eucalyptus	Idiogenes	?
E_coolabah_Ferguson2024	Eucalyptus	Symphyomyrtus	Adnataria
E_curtisii_Ferguson2024	Eucalyptus	Acerosae	?
E_dawsonii_Ferguson2024	Eucalyptus	Symphyomyrtus	Adnataria
E_decipiens_Ferguson2024	Eucalyptus	Symphyomyrtus	Bisectae
E_erythrocorys_Ferguson2024	Eucalyptus	Eudesmia	Limbatae
E_fibrosa_Ferguson2024	Eucalyptus	Symphyomyrtus	Adnataria
E_globulus_Ferguson2024	Eucalyptus	Symphyomyrtus	Maidenaria
E_grandis_Ferguson2024	Eucalyptus	Symphyomyrtus	Latoangulatae
E_guilfoylei_Ferguson2024	Eucalyptus	Cruciformes	?
E_lansdowneana_Ferguson2024	Eucalyptus	Symphyomyrtus	Adnataria
E_leucophloia_Ferguson2024	Eucalyptus	Symphyomyrtus	Platysperma
E_marginata_Ferguson2024	Eucalyptus	Eucalyptus	Longistylus
E_melliodora_Ferguson2024	Eucalyptus	Symphyomyrtus	Adnataria
E_microcorys_Ferguson2024	Eucalyptus	Alveolata	?
E_paniculata_Ferguson2024	Eucalyptus	Symphyomyrtus	Adnataria
E_pauciflora_Ferguson2024	Eucalyptus	Eucalyptus	Eucalyptus
E_polyanthemos_Ferguson2024	Eucalyptus	Symphyomyrtus	Adnataria
E_pumila_Ferguson2024	Eucalyptus	Symphyomyrtus	Pumilio
E_regnans_Ferguson2024	Eucalyptus	Eucalyptus	Eucalyptus
E_shirleyi_Ferguson2024	Eucalyptus	Symphyomyrtus	Adnataria
E_sid_E_mel_Ferguson2024	Eucalyptus-H	Symphyomyrtus	Adnataria
E_sideroxylon_Ferguson2024	Eucalyptus	Symphyomyrtus	Adnataria
E_tenuipes_Ferguson2024	Eucalyptus	Cuboidea	?
E_victrix_Ferguson2024	Eucalyptus	Symphyomyrtus	Adnataria
E_viminalis_Ferguson2024	Eucalyptus	Symphyomyrtus	Maidenaria
E_virginea_Ferguson2024	Eucalyptus	Symphyomyrtus	Bisectae
